1111111111111
10010000000C1
1000011111001
1P0011E000001
1111001000111
1C000010010C1
11100N0011001
1111000000001
1111111111111