1111111111111111111111
1C010000000000000000C1
1000011111000000000001
100011E0000P1111111111
111100100011C000000001
1C000010010C1111110001
1111000011001C00010001
1111000000000000000001
1111111111111111111111