11111111111111
10000C00000C01
1100100E001111
1010111110N011
1000C000N00N01
10000000000111
11P000110C00N1
11111111111111