1111111111111111111111
1C010N00000000000000C1
100000N0000000N0000001
100011E0000P00000N0001
100000100000000N000001
1C000010010C0000000001
1000N000011001C0001001
10000N0000000000000001
1111111111111111111111