11111111111111111111111111111
10000000000000000000000000001
1000000C000000000000000N00001
1000000000N000000000000000001
1000000000000000000000000C001
100000000000000E0000000000001
1000N00000000000000000N000001
100000000000N0000000000000001
100000C0000000000000000000001
100000000E000000000C000P00001
11111111111111111111111111111