11111111111111
10N00C00000C01
1100100E001111
1010111110N011
10000000000001
10000000000111
11P000110C00N1
11111111111111