11111111111111
1N000C00000C01
1100100E001111
1010111110N011
100000N0000001
10000000000111
11P000110C00N1
11111111111111