111111111111111111111111111111111111111111
100000000000000000000000000000000000000001
100000000N00N00000000N00N00N000000N0000001
100000000000000000000000000000000000000001
1000000000000000000000000C0000000000000001
100000000000000E0000000000000000N000000001
100000000000000000N00000000000000000000001
100000000000000N0N00000000N000000000000001
10000000000N0000000000000000N0000000000001
100000000E0000000000000P00000000000N000001
100000000000000N000000000000N0000000000001
10000000000000000000000000000000N000000001
10000000000N0000000N0000000000000000000001
100000000000000000000000000000000000000001
100000000E0000000N00N00000N000000N00000001
100000000000000000000000000000000000000001
100000000000000000000000000000000000000001
111111111111111111111111111111111111111111
