11111111111111
1N00000N000001
1100100E001111
10101111100011
10000000000N01
10000000000111
11P000110C00N1
11111111111111