1111111111111
10010000000C1
1000011111001
100011E000001
1111001000111
1C000010010C1
1111000011001
1111000000001
1111111111111